####################
#                 *
#              
#          ######### 
#      !           #
#                  #
#### 
#              
#
#
#          #
           #   
           #
   ################# 
              