           ########
                  *
        #           
        ########    
     !         #   #
                   #
                    
####         #######   
#            ##    #
#     ####         #
      #  #         #
#######  #######   #
                    
                    