####################
#       #         *
#       #          #
#       #    #######
##  #         #    #
#     !       #    #
#             #    #
###   #            #
#     #            #
#    ##        #####
     ####     #   ##
                  ##
                   #
  ################## 