#################
              #   *
      !       #    
              #    #
#                  #
###        # 
           ######  #
       ####     ####
  #####            #
          ####     #
         #     #
###  #   #      #
     #   #   #      
     #   #   #