#################
              #   *
   !          #    
       ####   #    #
#       #  #       #
#          #
###         #####  #
#  #            ####
#   ######        #
#        #####     #
         #     #
###  #   #      #
     #      #      
     #      # 