##         ########
#                 *
#   !              #
#       ############
#       #          #
#              #   #
#              #   #
####           #   #
#          ####    #
#         #        #
      ####    #    #
###                #
                   #
                   # 