####################
#       #         *
#       #    #     #
#       #    ###   #
#   !   #      #   #
#       #      #   #
#              #   #
###                #
#                  #
#                  #
     ####     #    #
              ######
                   #
  ################## 