#          ########
                  *
        #           
 !      ############
        #    #     #
        #    ###   #
       ##      #   #
#                  #
###                 
   ############    #
               ##   
###                #
         ####      #
         #         # 