####################
#               #  *
#    !              
#######     #      #
#   #       ####   #
#   #          #   #
#              #   #
##             #   #
#             ######
#    #   #####     #
     ####     ##   #
                   #
                   #
  ##################