#          ########
              #   *
             ##      
 !      #####      #
         ##       ##
           ###     #
    ##         #   #
      #            #
##     ##           
        ########   #
    #           #    
#####            ###
         #####     #
         #         #